#############################################################################################################################################
#...#...###.......#...#.....#...#.......#.........#.....###.....#...#...#.............#.......#.........#...###.........#...#.......#.....###
#.#.#.#.###.#####.#.#.#.###.#.#.#.#####.#.#######.#.###.###.###.#.#.#.#.#.###########.#.#####.#.#######.#.#.###.#######.#.#.#.#####.#.###.###
#.#...#...#.#.....#.#.#...#.#.#.#...#...#.....#...#...#...#...#.#.#...#.#.........#...#.#.....#...#.....#.#...#...#.....#.#.#...#...#...#...#
#.#######.#.#.#####.#.###.#.#.#.###.#.#######.#.#####.###.###.#.#.#####.#########.#.###.#.#######.#.#####.###.###.#.#####.#.###.#.#####.###.#
#.......#.#.#.#...#.#...#.#.#.#.....#.#...###.#.#...#.#...#...#...#...#.#.........#.....#...#...#.#...###.#...#...#.#...#.#...#.#.#...#.#...#
#######.#.#.#.#.#.#.###.#.#.#.#######.#.#.###.#.#.#.#.#.###.#######.#.#.#.#################.#.#.#.###.###.#.###.###.#.#.#.###.#.#.#.#.#.#.###
###.....#...#...#.#...#.#.#.#.....#...#.#.....#.#.#.#.#...#.#...#...#...#...............#...#.#.#.#...#...#...#.#...#.#.#.#...#.#.#.#.#.#.###
###.#############.###.#.#.#.#####.#.###.#######.#.#.#.###.#.#.#.#.#####################.#.###.#.#.#.###.#####.#.#.###.#.#.#.###.#.#.#.#.#.###
#...#.......#.....###.#.#.#.###...#...#.......#.#.#.#.#...#.#.#...#...###.......###.....#.###.#...#.....#.....#.#...#.#.#.#...#.#.#.#.#.#...#
#.###.#####.#.#######.#.#.#.###.#####.#######.#.#.#.#.#.###.#.#####.#.###.#####.###.#####.###.###########.#####.###.#.#.#.###.#.#.#.#.#.###.#
#.....#.....#...###...#...#.....#.....###.....#.#.#.#.#.#...#.....#.#...#.....#.#...#...#.#...#.....#...#.#...#.#...#.#.#.#...#.#.#.#.#.#...#
#######.#######.###.#############.#######.#####.#.#.#.#.#.#######.#.###.#####.#.#.###.#.#.#.###.###.#.#.#.#.#.#.#.###.#.#.#.###.#.#.#.#.#.###
#...###.......#...#.............#...#...#...#...#.#.#.#.#.#.......#.#...#...#.#.#.....#.#.#...#...#.#.#...#.#.#.#...#.#.#.#.....#...#...#...#
#.#.#########.###.#############.###.#.#.###.#.###.#.#.#.#.#.#######.#.###.#.#.#.#######.#.###.###.#.#.#####.#.#.###.#.#.#.#################.#
#.#.#.......#.#...#...###...#...#...#.#.....#...#.#.#.#...#...#...#.#.#...#...#...#.....#.#...#...#...#...#.#...#...#.#...#...#.........#...#
#.#.#.#####.#.#.###.#.###.#.#.###.###.#########.#.#.#.#######.#.#.#.#.#.#########.#.#####.#.###.#######.#.#.#####.###.#####.#.#.#######.#.###
#.#.#.....#...#.....#.#...#...#...###.......#...#.#.#.#.....#.#.#.#.#.#.......#...#.....#...#...#.....#.#.#.....#.#...#.....#...###...#.#...#
#.#.#####.###########.#.#######.###########.#.###.#.#.#.###.#.#.#.#.#.#######.#.#######.#####.###.###.#.#.#####.#.#.###.###########.#.#.###.#
#.#.....#.......#...#.#.......#.#...#...#...#...#.#...#...#...#.#.#.#.#.......#.....#...#...#.....#...#.#.......#...#...#.......#...#.#.....#
#.#####.#######.#.#.#.#######.#.#.#.#.#.#.#####.#.#######.#####.#.#.#.#.###########.#.###.#.#######.###.#############.###.#####.#.###.#######
#.....#.###...#.#.#...#...#...#.#.#...#.#.#...#...#.......#...#.#...#.#.....#.......#...#.#.#...#...###...#.....#.....###.#.....#.#...#.....#
#####.#.###.#.#.#.#####.#.#.###.#.#####.#.#.#.#####.#######.#.#.#####.#####.#.#########.#.#.#.#.#.#######.#.###.#.#######.#.#####.#.###.###.#
#.....#...#.#.#.#.#...#.#.#...#.#...#...#...#...#...###...#.#.#.....#.#.....#.....#...#.#.#...#...#.....#...#...#.........#.......#...#...#.#
#.#######.#.#.#.#.#.#.#.#.###.#.###.#.#########.#.#####.#.#.#.#####.#.#.#########.#.#.#.#.#########.###.#####.#######################.###.#.#
#.#.....#...#...#...#.#.#.....#...#.#...#...###.#.....#.#.#.#.###...#.#.........#...#.#.#.....#...#.#...#.....#...#...#...#...#.....#.#...#.#
#.#.###.#############.#.#########.#.###.#.#.###.#####.#.#.#.#.###.###.#########.#####.#.#####.#.#.#.#.###.#####.#.#.#.#.#.#.#.#.###.#.#.###.#
#...###...#.........#...#.......#.#.#...#.#.#...#.....#.#...#.#...#...#.......#.....#...#...#...#.#.#.#...#.....#.#.#...#.#.#...#...#.#.#...#
#########.#.#######.#####.#####.#.#.#.###.#.#.###.#####.#####.#.###.###.#####.#####.#####.#.#####.#.#.#.###.#####.#.#####.#.#####.###.#.#.###
#.........#.#.......#.....#.....#.#.#.###.#.#...#.....#.#.....#...#.###...#...#...#.....#.#.......#.#.#...#.....#.#.....#.#.....#...#...#...#
#.#########.#.#######.#####.#####.#.#.###.#.###.#####.#.#.#######.#.#####.#.###.#.#####.#.#########.#.###.#####.#.#####.#.#####.###.#######.#
#.....#.....#.........#...#.....#.#.#.#...#.#...#.....#.#...#...#.#.#...#.#.#...#.#.....#...#.....#.#...#.#.....#...#...#.#...#.#...#.....#.#
#####.#.###############.#.#####.#.#.#.#.###.#.###.#####.###.#.#.#.#.#.#.#.#.#.###.#.#######.#.###.#.###.#.#.#######.#.###.#.#.#.#.###.###.#.#
#.....#...#E............#.....#.#.#.#.#...#.#...#.#...#.#...#.#.#.#.#.#.#.#.#...#.#.....#...#...#.#...#.#.#.###...#...###...#...#...#...#.#.#
#.#######.###################.#.#.#.#.###.#.###.#.#.#.#.#.###.#.#.#.#.#.#.#.###.#.#####.#.#####.#.###.#.#.#.###.#.#################.###.#.#.#
#...#.....###################...#...#...#.#.#...#.#.#.#.#.....#.#.#.#.#...#.#...#...#...#.#...#.#...#.#...#.....#.........#...#...#.#...#.#.#
###.#.#################################.#.#.#.###.#.#.#.#######.#.#.#.#####.#.#####.#.###.#.#.#.###.#.###################.#.#.#.#.#.#.###.#.#
###...#...#...#########################.#.#.#...#...#.#.......#.#.#.#.#.....#...###.#...#.#.#.#.#...#.#.....#...#...#.....#.#.#.#.#...#...#.#
#######.#.#.#.#########################.#.#.###.#####.#######.#.#.#.#.#.#######.###.###.#.#.#.#.#.###.#.###.#.#.#.#.#.#####.#.#.#.#####.###.#
#.......#.#.#.#########################...#.#...#.....#...#...#...#.#.#...#...#...#.#...#.#.#...#...#.#...#...#...#...#.....#...#.....#.....#
#.#######.#.#.#############################.#.###.#####.#.#.#######.#.###.#.#.###.#.#.###.#.#######.#.###.#############.#############.#######
#.......#.#.#.#...#########################.#...#.....#.#.#.......#.#.#...#.#.#...#.#...#.#.#.......#.###...#.......#...#.............###...#
#######.#.#.#.#.#.#########################.###.#####.#.#.#######.#.#.#.###.#.#.###.###.#.#.#.#######.#####.#.#####.#.###.###############.#.#
#.......#.#.#.#.#...#######################.#...#.....#.#.#.....#.#.#.#...#.#...#...#...#.#.#.#.....#.#.....#.#.....#...#.#.............#.#.#
#.#######.#.#.#.###.#######################.#.###.#####.#.#.###.#.#.#.###.#.#####.###.###.#.#.#.###.#.#.#####.#.#######.#.#.###########.#.#.#
#.......#...#...#...#######################...###.....#.#...#...#.#.#.###.#.....#...#...#.#.#.#.###...#.......#.........#...#...........#.#.#
#######.#########.###################################.#.#####.###.#.#.###.#####.###.###.#.#.#.#.#############################.###########.#.#
#...###.........#.#######S###############.....#...#...#...#...#...#...#...#...#...#...#.#.#.#.#.#.......................#.....###...#...#.#.#
#.#.###########.#.#######.###############.###.#.#.#.#####.#.###.#######.###.#.###.###.#.#.#.#.#.#.#####################.#.#######.#.#.#.#.#.#
#.#.......#.....#.#######.#...#.........#.#...#.#...#.....#...#.....###...#.#.....###.#.#.#.#.#.#.....................#...#.....#.#...#.#.#.#
#.#######.#.#####.#######.#.#.#.#######.#.#.###.#####.#######.#####.#####.#.#########.#.#.#.#.#.#####################.#####.###.#.#####.#.#.#
#.#.....#.#.....#.#######.#.#.#.#.......#.#...#.#...#...###...#...#...#...#.......#...#.#.#.#...#...#.........#.......#...#...#...#.....#.#.#
#.#.###.#.#####.#.#######.#.#.#.#.#######.###.#.#.#.###.###.###.#.###.#.#########.#.###.#.#.#####.#.#.#######.#.#######.#.###.#####.#####.#.#
#.#.#...#.......#.....###...#.#.#.......#.#...#...#...#...#...#.#...#.#.#...#...#.#...#.#.#.###...#...#.....#.#...#.....#.....#...#.......#.#
#.#.#.###############.#######.#.#######.#.#.#########.###.###.#.###.#.#.#.#.#.#.#.###.#.#.#.###.#######.###.#.###.#.###########.#.#########.#
#...#...............#.#.....#...###...#.#.#.......#...#...#...#...#.#.#.#.#.#.#.#...#...#...#...#.......#...#.....#.#.......#...#.#.....#...#
###################.#.#.###.#######.#.#.#.#######.#.###.###.#####.#.#.#.#.#.#.#.###.#########.###.#######.#########.#.#####.#.###.#.###.#.###
#...............###.#.#...#.....#...#...#.#.......#...#...#...#...#.#.#.#.#...#...#...#.......#...###.....#...#.....#.....#.#...#...###...###
#.#############.###.#.###.#####.#.#######.#.#########.###.###.#.###.#.#.#.#######.###.#.#######.#####.#####.#.#.#########.#.###.#############
#.......#.....#...#.#.#...#.....#...###...#.........#...#...#...###.#.#...#...###.#...#.......#.#.....#.....#.#...#.......#.....#...#...#...#
#######.#.###.###.#.#.#.###.#######.###.###########.###.###.#######.#.#####.#.###.#.#########.#.#.#####.#####.###.#.#############.#.#.#.#.#.#
###...#...###...#...#.#...#.###...#.....#...#.....#...#...#.....#...#.....#.#.#...#.#.....###...#.......#...#.#...#...............#...#...#.#
###.#.#########.#####.###.#.###.#.#######.#.#.###.###.###.#####.#.#######.#.#.#.###.#.###.###############.#.#.#.###########################.#
#...#...........#...#.....#.....#.#.......#.#...#...#...#.#.....#.....#...#.#.#.....#.#...#...###.........#...#.#.........#...............#.#
#.###############.#.#############.#.#######.###.###.###.#.#.#########.#.###.#.#######.#.###.#.###.#############.#.#######.#.#############.#.#
#.........#.......#...#.....#.....#.#...###.....###.....#...#...#...#...###.#.###...#.#.....#...#.........#.....#.......#.#.............#...#
#########.#.#########.#.###.#.#####.#.#.#####################.#.#.#.#######.#.###.#.#.#########.#########.#.###########.#.#############.#####
#.........#.#...#.....#.###.#.....#...#.......#...#.....#.....#...#...###...#.....#.#.#...#...#...###.....#.#...........#...#...#...#...#...#
#.#########.#.#.#.#####.###.#####.###########.#.#.#.###.#.###########.###.#########.#.#.#.#.#.###.###.#####.#.#############.#.#.#.#.#.###.#.#
#...#...#...#.#...#...#...#.....#.#...#.......#.#.#.#...#.#.........#.#...#.........#.#.#...#...#.....#.....#.........#...#...#...#...###.#.#
###.#.#.#.###.#####.#.###.#####.#.#.#.#.#######.#.#.#.###.#.#######.#.#.###.#########.#.#######.#######.#############.#.#.###############.#.#
###...#...#...#...#.#.#...#.....#...#...#...#...#...#.....#.....###...#...#.......###...###...#.........#...#...#.....#.#.#...###.......#.#.#
###########.###.#.#.#.#.###.#############.#.#.#################.#########.#######.#########.#.###########.#.#.#.#.#####.#.#.#.###.#####.#.#.#
#...#...###.....#.#.#.#.###.#...#.........#...#.....#...........#...###...#.......#...#...#.#.#...###.....#...#...###...#...#.....#...#...#.#
#.#.#.#.#########.#.#.#.###.#.#.#.#############.###.#.###########.#.###.###.#######.#.#.#.#.#.#.#.###.###############.#############.#.#####.#
#.#...#.......###...#.#...#...#...#...#.........###...#...........#.#...#...#...#...#.#.#.#.#.#.#.....#...###...#...#.#...#.....#...#.#.....#
#.###########.#######.###.#########.#.#.###############.###########.#.###.###.#.#.###.#.#.#.#.#.#######.#.###.#.#.#.#.#.#.#.###.#.###.#.#####
#.#.........#.#...#...#...#.........#...###...........#...#.....#...#...#...#.#.#.#...#.#.#.#.#.........#.....#...#...#.#.#...#...#...#.....#
#.#.#######.#.#.#.#.###.###.###############.#########.###.#.###.#.#####.###.#.#.#.#.###.#.#.#.#########################.#.###.#####.#######.#
#...###...#.#...#.#.....###.#...#.........#.#.....#...#...#.###...#...#.#...#.#.#.#.....#...#...#...#.......#.....#...#.#.#...#...#.......#.#
#######.#.#.#####.#########.#.#.#.#######.#.#.###.#.###.###.#######.#.#.#.###.#.#.#############.#.#.#.#####.#.###.#.#.#.#.#.###.#.#######.#.#
#.......#.#.....#.#...#...#...#...#.....#...#...#...###...#...#...#.#.#.#.#...#.#.....#.......#.#.#.#.....#.#...#.#.#.#.#.#...#.#.#...###...#
#.#######.#####.#.#.#.#.#.#########.###.#######.#########.###.#.#.#.#.#.#.#.###.#####.#.#####.#.#.#.#####.#.###.#.#.#.#.#.###.#.#.#.#.#######
#.#.....#.......#...#.#.#.#...###...###.......#...###.....#...#.#...#.#.#...#...#...#.#.#.....#...#...#...#.....#...#...#.....#.#.#.#.......#
#.#.###.#############.#.#.#.#.###.###########.###.###.#####.###.#####.#.#####.###.#.#.#.#.###########.#.#######################.#.#.#######.#
#...###...#.....#...#...#.#.#...#...........#...#...#.....#...#.#...#...#.....#...#.#.#.#...#.......#.#...........#.......#...#.#.#.#.......#
#########.#.###.#.#.#####.#.###.###########.###.###.#####.###.#.#.#.#####.#####.###.#.#.###.#.#####.#.###########.#.#####.#.#.#.#.#.#.#######
#.........#.###...#.....#.#...#.............###.....#...#.#...#...#...#...#...#...#.#...###...#.....#.......#.....#.#.....#.#...#...#...#...#
#.#########.###########.#.###.#######################.#.#.#.#########.#.###.#.###.#.###########.###########.#.#####.#.#####.###########.#.#.#
#.......#...#...#...#...#.....#.............###...#...#.#.#...###...#.#.....#.#...#.....#...###...#...#...#...#...#.#...#...#.........#...#.#
#######.#.###.#.#.#.#.#########.###########.###.#.#.###.#.###.###.#.#.#######.#.#######.#.#.#####.#.#.#.#.#####.#.#.###.#.###.#######.#####.#
#...###...###.#...#...#...#...#.#...........#...#.#.#...#.#...#...#.#.#.......#.#.......#.#.#.....#.#.#.#.....#.#.#...#.#.#...#.....#.#.....#
#.#.#########.#########.#.#.#.#.#.###########.###.#.#.###.#.###.###.#.#.#######.#.#######.#.#.#####.#.#.#####.#.#.###.#.#.#.###.###.#.#.#####
#.#...........#.....#...#.#.#...#...........#.#...#.#.#...#...#...#...#...###...#.......#.#.#.......#...#...#...#.....#...#.....#...#...#...#
#.#############.###.#.###.#.###############.#.#.###.#.#.#####.###.#######.###.#########.#.#.#############.#.#####################.#######.#.#
#.#...#...#...#.#...#.#...#.#...............#.#.#...#.#.#...#...#.......#...#...#...#...#.#.#...#.........#.#...#...#...#...#...#...###...#.#
#.#.#.#.#.#.#.#.#.###.#.###.#.###############.#.#.###.#.#.#.###.#######.###.###.#.#.#.###.#.#.#.#.#########.#.#.#.#.#.#.#.#.#.#.###.###.###.#
#.#.#.#.#...#...#.#...#...#.#...#.....#.......#.#...#.#.#.#.....#.......#...#...#.#...#...#...#.#.....#...#...#.#.#.#.#.#.#.#.#...#.....#...#
#.#.#.#.#########.#.#####.#.###.#.###.#.#######.###.#.#.#.#######.#######.###.###.#####.#######.#####.#.#.#####.#.#.#.#.#.#.#.###.#######.###
#.#.#.#.#.....#...#.#...#...#...#.#...#.#.......#...#...#...#...#.......#.###...#...###.#.......#...#...#.....#.#.#...#...#...#...#...#...###
#.#.#.#.#.###.#.###.#.#.#####.###.#.###.#.#######.#########.#.#.#######.#.#####.###.###.#.#######.#.#########.#.#.#############.###.#.#.#####
#...#...#...#.#.....#.#.....#.....#...#.#.....###...#.......#.#.#...#...#...###...#...#.#.#.....#.#.#...#...#.#.#.......###...#...#.#.#.....#
###########.#.#######.#####.#########.#.#####.#####.#.#######.#.#.#.#.#####.#####.###.#.#.#.###.#.#.#.#.#.#.#.#.#######.###.#.###.#.#.#####.#
###...#...#.#.#...###.....#.#...#.....#.#.....#...#.#.###...#.#.#.#.#.#.....#...#...#.#.#.#.#...#.#.#.#.#.#...#...#...#.....#...#...#.#.....#
###.#.#.#.#.#.#.#.#######.#.#.#.#.#####.#.#####.#.#.#.###.#.#.#.#.#.#.#.#####.#.###.#.#.#.#.#.###.#.#.#.#.#######.#.#.#########.#####.#.#####
#...#...#...#.#.#.......#.#...#...#...#.#...#...#.#.#.#...#.#.#.#.#.#.#...#...#.#...#.#.#...#...#.#...#.#...#...#...#...#.....#...###.#.....#
#.###########.#.#######.#.#########.#.#.###.#.###.#.#.#.###.#.#.#.#.#.###.#.###.#.###.#.#######.#.#####.###.#.#.#######.#.###.###.###.#####.#
#.....#.....#...#.....#...#.......#.#.#.#...#...#.#.#.#.#...#.#.#.#...#...#...#.#...#.#.#.......#...###...#...#.....###...###.#...#...#...#.#
#####.#.###.#####.###.#####.#####.#.#.#.#.#####.#.#.#.#.#.###.#.#.#####.#####.#.###.#.#.#.#########.#####.#########.#########.#.###.###.#.#.#
#.....#.###.....#...#.....#...#...#.#...#...#...#...#.#.#.#...#.#.....#...#...#.#...#.#.#...#.....#.....#.#.......#.......#...#...#...#.#...#
#.#####.#######.###.#####.###.#.###.#######.#.#######.#.#.#.###.#####.###.#.###.#.###.#.###.#.###.#####.#.#.#####.#######.#.#####.###.#.#####
#.#...#.#.......#...#...#...#.#...#.....#...#.#.......#.#.#.#...#.....#...#.###.#...#.#.#...#.###.#.....#...#...#.........#.#.....#...#.....#
#.#.#.#.#.#######.###.#.###.#.###.#####.#.###.#.#######.#.#.#.###.#####.###.###.###.#.#.#.###.###.#.#########.#.###########.#.#####.#######.#
#.#.#...#.......#.....#.###...###.#...#.#.#...#.....#...#.#.#...#.....#...#...#.....#.#.#...#.#...#...........#.........###...#.....#...#...#
#.#.###########.#######.#########.#.#.#.#.#.#######.#.###.#.###.#####.###.###.#######.#.###.#.#.#######################.#######.#####.#.#.###
#.#...###...###.#.......#.........#.#...#.#.#.......#.#...#.#...#...#...#...#.....###...###...#...#...#...#...#.........#...###.......#...###
#.###.###.#.###.#.#######.#########.#####.#.#.#######.#.###.#.###.#.###.###.#####.###############.#.#.#.#.#.#.#.#########.#.#################
#.#...#...#.....#...#.....#...#...#.....#.#.#.#...#...#...#.#...#.#.....###.#...#.......###.......#.#.#.#...#.#...........#.....#...........#
#.#.###.###########.#.#####.#.#.#.#####.#.#.#.#.#.#.#####.#.###.#.#########.#.#.#######.###.#######.#.#.#####.#################.#.#########.#
#...###.........#...#.#...#.#...#...#...#.#.#.#.#.#...###.#.#...#.......#...#.#.#.......#...#...#...#.#.###...#...........#.....#.....#...#.#
###############.#.###.#.#.#.#######.#.###.#.#.#.#.###.###.#.#.#########.#.###.#.#.#######.###.#.#.###.#.###.###.#########.#.#########.#.#.#.#
#...............#.###...#.#.#.......#.###.#.#.#.#.#...#...#.#...#...#...#.#...#.#.#.....#...#.#.#...#.#...#...#.........#...#...###...#.#.#.#
#.###############.#######.#.#.#######.###.#.#.#.#.#.###.###.###.#.#.#.###.#.###.#.#.###.###.#.#.###.#.###.###.#########.#####.#.###.###.#.#.#
#.#...#.......#...#.......#.#...#...#...#.#.#.#.#.#.#...#...#...#.#.#.###.#.###.#...#...###.#.#...#.#...#...#...#.....#.......#.....#...#...#
#.#.#.#.#####.#.###.#######.###.#.#.###.#.#.#.#.#.#.#.###.###.###.#.#.###.#.###.#####.#####.#.###.#.###.###.###.#.###.###############.#######
#...#.#.#.....#...#...#...#...#.#.#...#.#...#.#.#.#.#.#...###...#.#.#...#.#.#...#...#.....#...#...#...#...#...#.#...#.....#.....#...#.......#
#####.#.#.#######.###.#.#.###.#.#.###.#.#####.#.#.#.#.#.#######.#.#.###.#.#.#.###.#.#####.#####.#####.###.###.#.###.#####.#.###.#.#.#######.#
#.....#.#.#.....#.###...#.#...#.#...#.#...###...#.#.#...#.......#.#.#...#...#.#...#.#.....#...#...#...###...#.#...#.....#.#...#.#.#...#...#.#
#.#####.#.#.###.#.#######.#.###.###.#.###.#######.#.#####.#######.#.#.#######.#.###.#.#####.#.###.#.#######.#.###.#####.#.###.#.#.###.#.#.#.#
#.#...#.#.#...#.#.#.....#.#.#...#...#...#.....###.#...###...#...#.#.#.#...###.#...#.#.......#...#...#.......#.###...#...#.....#.#.###...#.#.#
#.#.#.#.#.###.#.#.#.###.#.#.#.###.#####.#####.###.###.#####.#.#.#.#.#.#.#.###.###.#.###########.#####.#######.#####.#.#########.#.#######.#.#
#...#...#...#.#.#.#...#...#.#...#...#...#...#...#.....#...#.#.#...#.#...#...#...#.#...#...#...#.....#.......#.#...#.#.........#.#.......#.#.#
###########.#.#.#.###.#####.###.###.#.###.#.###.#######.#.#.#.#####.#######.###.#.###.#.#.#.#.#####.#######.#.#.#.#.#########.#.#######.#.#.#
#...........#.#.#...#.....#...#...#.#.....#.#...#.......#...#.###...#...#...###.#.###...#.#.#.......#...###...#.#...#...#.....#.........#.#.#
#.###########.#.###.#####.###.###.#.#######.#.###.###########.###.###.#.#.#####.#.#######.#.#########.#.#######.#####.#.#.###############.#.#
#...#...#...#.#.....#.....#...#...#.......#.#.###...#...#...#.#...#...#.#.#...#.#...#.....#.....###...#.........#...#.#.#.#...#...#...###...#
###.#.#.#.#.#.#######.#####.###.#########.#.#.#####.#.#.#.#.#.#.###.###.#.#.#.#.###.#.#########.###.#############.#.#.#.#.#.#.#.#.#.#.#######
#...#.#.#.#.#.#.......#...#...#...#...#...#.#.....#.#.#.#.#.#.#...#.#...#...#.#.#...#.#...#...#...#.#...#...#...#.#.#.#.#...#...#...#.......#
#.###.#.#.#.#.#.#######.#.###.###.#.#.#.###.#####.#.#.#.#.#.#.###.#.#.#######.#.#.###.#.#.#.#.###.#.#.#.#.#.#.#.#.#.#.#.###################.#
#.....#...#...#.........#.....###...#...###.......#...#...#...###...#.........#...###...#...#.....#...#...#...#...#...#.....................#
#############################################################################################################################################

